###################
#********#********#
#*##*###*#*###*##*#
#&##*###*#*###*##&#
#*****************#
#*##*#*#####*#*##*#
#****#***#***#****#
####*###*#*###*####
___#*#___1___#*#___
####*#_##!##_#*####
____*_&#243#&_*____
####*#_#####_#*####
___#*#_______#*#___
####*#_#####_#*####
#********#********#
#*##*###*#*###*##*#
#&*#*****@*****#*&#
##*#*#*#####*#*#*##
#****#***#***#****#
#*######*#*######*#
#*****************#
###################